6 6
0 1
# . # # # #
# . # . . #
# . . F . #
# . # # . #
# . . . . #
# # # . . #
